Oliver	warren
jake	Allen
will	Lopez
james	Green
jack	Gonzalez
liam	Baker
jhon	Adams
eve	Perez
michael	Campbell
isabella Shaw
scarlet	Stanley
carrie	Holland
linda	Terry
sam	Shelton
charlotte Miles
miranda	Lucas
amy 	Fletcher
megan	Parks
mia	Norris
barbara	Guzman
harry 	Daniel
robert	Lee
jacob	Potter
harry	Francis
robert	Erickson